Diana	Parsons
Alexandra	Ellison
Justin	Rees
Tim	Vaughan
Carolyn	Newman
Piers	Poole
Lauren	Hemmings
Sue	Bower
Ryan	Kelly
Dylan	Buckland
Thomas	Ross
Tim	Edmunds
Grace	May
Maria	Short
Andrew	Alsop
Neil	Buckland
Deirdre	Roberts
Benjamin	Mitchell
Joseph	McLean
Julian	Miller
Leonard	McGrath
Faith	Anderson
Kimberly	Bond
Adrian	Russell
Liam	Sanderson
Peter	Kelly
Jonathan	Davies
Ian	Murray
James	North
Connor	Arnold
Sophie	Lambert
Isaac	Lambert
Tim	Poole
Warren	Duncan
Carolyn	Quinn
Fiona	Davies
Ava	McLean
Owen	Duncan
Melanie	Poole
Hannah	Kelly
Jake	Gibson
Diana	Walsh
Kylie	Piper
Adam	White
Piers	Kelly
Robert	Bower
Anne	Parsons
Victoria	May
Blake	Graham
Gordon	MacLeod
Nathan	Metcalfe
Boris	Slater
Benjamin	Davidson
Joseph	Scott
Ava	Slater
Abigail	Parr
Carl	Dickens
Alan	Dowd
Faith	Forsyth
Bernadette	MacDonald
Rachel	Brown
John	Ogden
Ava	Vance
Yvonne	Clarkson
Michelle	Lyman
Claire	Davidson
Harry	Murray
Sally	Sutherland
William	Fraser
Jane	Mathis
Fiona	Hardacre
Charles	Johnston
Una	Ferguson
Oliver	Anderson
Frank	Young
Jane	Parr
Amanda	Buckland
Megan	McLean
Jessica	Oliver
Jane	Harris
